World_v1
12 8
  0  -1  -1    0  -1  -1    0  -1  -1    0  -1  -1    0  -1  -1    0  -1  -1    0  -1  -1    0  -1  -1    0  -1  -1    0  -1  -1    0  -1  -1    0  -1  -1  
  0  -1  -1    0  -1  -1    0  -1  -1    0  -1  -1    0  -1  -1    0  -1  -1    0  -1  -1    0  -1  -1    0  -1  -1    0  -1  -1    0  -1  -1    0  -1  -1  
  2  -1  -1    2  -1  -1    2  -1  -1    2  -1  -1    2  -1  -1    2  -1  -1    7  -1  -1    0  -1  -1    0  -1  -1    0  -1  -1    0  -1  -1    0  -1  -1  
  1  -1  -1    1  -1  -1    1  -1  -1    1  -1  -1    1  -1  -1    1  -1  -1    6  -1  -1    0  -1  -1    9  -1  -1    0  -1  -1    0  -1  -1    0  -1  -1  
  3  -1  -1    3  -1  -1    3  -1  -1    3  -1  -1    3  -1  -1    3  -1  -1    5  -1  -1    0  -1  -1    0  -1  -1    0  -1  -1    0  -1  -1    0  -1  -1  
  0  -1  -1    0  -1  -1    0   4  -1    0   4  -1    0   4  -1    0   4  -1    0   4  -1    0   4  -1    0   4  -1    0   4  -1    0  -1  -1    0  -1  -1  
  0  -1  -1    0  -1  -1    0  -1  -1    0  -1  -1    0  -1  -1    0  -1  -1    0  -1  -1    0  -1  -1    0  -1  -1    0  -1  -1    0  -1  -1    0  -1  -1  
  0  -1  -1    0  -1  -1    0  -1  -1    0  -1  -1    0  -1  -1    0  -1  -1    0  -1  -1    0  -1  -1    0  -1  -1    0  -1  -1    0  -1  -1    0  -1  -1  
1

3 4
0
8

